################
#......#.......#
#......#.......#
#..#...#.......#
#..............#
#..............#
#..##..........#
#..............#
#..............#
#.....#........#
#..............#
#..........#...#
#..........#...#
#..........#...#
#..........#...#
################
