################################
#......#.......#.......#####...#
#......#.......#.####....##..#.#
#..#...#.......#....#.##....##.#
#..............######.#....#####
#..............................#
#..##..........................#
#.........................######
#..............................#
#.....#.................#..#...#
#.......................#..#.###
#..........#............#..#..##
#..........#...#.########..#####
#..........#...#..#..........###
#..........#...##....##..###...#
#..............................#
#..............................#
#..............................#
#..............................#
#..............................#
#..............................#
#..............................#
#..............................#
#..............................#
#..............................#
#..............................#
#..............................#
#..............................#
#..............................#
#..............................#
#..............................#
################################

