################################
#......#.......#.......#####...#
#......#.###...#.####....##..#.#
#..#...#.#.#...#....#.##....##.#
#........#.#...######.#....#####
#........#.....................#
#..##..####....................#
#........#................######
####...........................#
#.....#.....##########..#..#...#
#....................#..#..#.###
###........#.........#..#..#..##
#....##....#...#.########..#####
#.....#....#...#..#..........###
#######....#...##....##..###...#
#..............................#
#####.#................##......#
#...#..#................#......#
#....#..#......................#
#.....#..#......####...........#
#......#..###......#...........#
#.##....#......#......###......#
#..............#...............#
#...##..####...#...........#####
#######....#...#....#..........#
#..........#####....#####......#
#...................#......#...#
#.............#######.....###..#
#.....######............########
#.#####....#.......#...........#
#.....#...........##...........#
################################

